#####
#0#0#
#000#
#0#0#
#####
